###############
#             #
#  *          #
#             #
#      %      #
#             #
#             #
#             #
###           #
#*D           #
###        $  #
#             #
#  ^          #
###############